"GROUP","NREP_TOTAL","NREP_STD_METHOD","NREP_SEC_METHOD","POSREP_TOTAL","POSREP_STD_METHOD","POSREP_SEC_METHOD"
"ABSO","1432","1161","271","6","5","1"
"ABSX","1432","1161","271","29","26","3"
"ACAC","1432","1161","271","450","364","86"
"ACAL","1432","1161","271","94","90","4"
"ACBL","1432","1161","271","174","148","26"
"ACGU","1432","1161","271","102","100","2"
"ACLI","1432","1161","271","397","354","43"
"ACLU","1432","1161","271","45","31","14"
"ACMA","1432","1161","271","123","104","19"
"ACMT","1432","1161","271","24","22","2"
"ACNC","1432","1161","271","1109","914","195"
"ACNF","1432","1161","271","1016","836","180"
"ACNI","1432","1161","271","102","78","24"
"ACNR","1432","1161","271","279","218","61"
"ACOL","1432","1161","271","331","273","58"
"ACPY","1432","1161","271","352","297","55"
"ACSP","1432","1161","271","122","81","41"
"ACTH","1432","1161","271","410","356","54"
"ACTR","1432","1161","271","97","91","6"
"ACXA","1432","1161","271","46","41","5"
"ALSC","1432","1161","271","15","14","1"
"AMCH","1432","1161","271","96","88","8"
"AMSC","1432","1161","271","131","122","9"
"ANCA","1432","1161","271","113","109","4"
"ANME","1432","1161","271","60","58","2"
"ANMG","1432","1161","271","48","40","8"
"ANSP","1432","1161","271","5","3","2"
"ANTH","1432","1161","271","11","7","4"
"ANTW","1432","1161","271","340","315","25"
"APFU","1432","1161","271","798","672","126"
"APSP","1432","1161","271","16","9","7"
"APTR","1432","1161","271","111","105","6"
"APVI","1432","1161","271","97","91","6"
"ARME","1432","1161","271","44","37","7"
"ARNI","1432","1161","271","32","28","4"
"ASTA","1432","1161","271","9","7","2"
"AUCH","1432","1161","271","40","38","2"
"BACO","1432","1161","271","36","33","3"
"BAUN","1432","1161","271","1186","1027","159"
"BAVI","1432","1161","271","84","70","14"
"BLCH","1432","1161","271","5","3","2"
"BLEN","1432","1161","271","446","387","59"
"BOAX","1432","1161","271","270","226","44"
"BOLO","1432","1161","271","96","81","15"
"CAAB","1432","1161","271","45","43","2"
"CAAM","1432","1161","271","61","55","6"
"CACA","1432","1161","271","224","205","19"
"CACE","1432","1161","271","65","60","5"
"CADU","1432","1161","271","200","178","22"
"CAFE","1432","1161","271","9","8","1"
"CAJN","1432","1161","271","20","19","1"
"CALU","1432","1161","271","49","42","7"
"CAMC","1432","1161","271","80","61","19"
"CAME","1432","1161","271","357","312","45"
"CAOR","1432","1161","271","43","42","1"
"CAPA","1432","1161","271","180","176","4"
"CARD","1432","1161","271","12","10","2"
"CASE","1432","1161","271","13","9","4"
"CASO","1432","1161","271","62","51","11"
"CATE","1432","1161","271","219","205","14"
"CAVA","1432","1161","271","13","10","3"
"CEAR","1432","1161","271","991","811","180"
"CEBC","1432","1161","271","77","68","9"
"CEBI","1432","1161","271","502","430","72"
"CEFL","1432","1161","271","1222","1016","206"
"CEHE","1432","1161","271","88","85","3"
"CELE","1432","1161","271","137","99","38"
"CELO","1432","1161","271","392","293","99"
"CEOC","1432","1161","271","102","92","10"
"CESP","1432","1161","271","62","53","9"
"CEUR","1432","1161","271","1183","966","217"
"CHAC","1432","1161","271","807","633","174"
"CHAG","1432","1161","271","293","229","64"
"CHAL","1432","1161","271","42","41","1"
"CHAM","1432","1161","271","61","50","11"
"CHAU","1432","1161","271","110","95","15"
"CHBE","1432","1161","271","47","42","5"
"CHBI","1432","1161","271","39","32","7"
"CHBR","1432","1161","271","291","256","35"
"CHCH","1432","1161","271","6","3","3"
"CHCI","1432","1161","271","260","242","18"
"CHCL","1432","1161","271","28","27","1"
"CHCY","1432","1161","271","23","2","21"
"CHEP","1432","1161","271","325","293","32"
"CHFA","1432","1161","271","25","20","5"
"CHFN","1432","1161","271","186","169","17"
"CHGL","1432","1161","271","10","6","4"
"CHIO","1432","1161","271","779","629","150"
"CHJA","1432","1161","271","459","406","53"
"CHLT","1432","1161","271","273","246","27"
"CHLU","1432","1161","271","385","355","30"
"CHMA","1432","1161","271","995","804","191"
"CHMC","1432","1161","271","298","272","26"
"CHMD","1432","1161","271","14","11","3"
"CHML","1432","1161","271","34","33","1"
"CHMR","1432","1161","271","47","44","3"
"CHOR","1432","1161","271","480","419","61"
"CHOX","1432","1161","271","217","216","1"
"CHPW","1432","1161","271","784","651","133"
"CHQU","1432","1161","271","230","211","19"
"CHRA","1432","1161","271","33","31","2"
"CHRE","1432","1161","271","1117","945","172"
"CHSE","1432","1161","271","72","69","3"
"CHSL","1432","1161","271","783","673","110"
"CHSP","1432","1161","271","4","3","1"
"CHTA","1432","1161","271","439","361","78"
"CHTE","1432","1161","271","21","17","4"
"CHTL","1432","1161","271","127","124","3"
"CHTR","1432","1161","271","221","198","23"
"CHUB","1432","1161","271","90","77","13"
"CHUD","1432","1161","271","126","120","6"
"CHUL","1432","1161","271","118","113","5"
"CHUN","1432","1161","271","281","240","41"
"CHVA","1432","1161","271","222","189","33"
"CHVG","1432","1161","271","222","204","18"
"CHWE","1432","1161","271","14","13","1"
"CHXA","1432","1161","271","693","605","88"
"CIFL","1432","1161","271","88","73","15"
"CILB","1432","1161","271","71","63","8"
"CIPI","1432","1161","271","53","50","3"
"CIPO","1432","1161","271","59","48","11"
"CIPU","1432","1161","271","5","3","2"
"CISP","1432","1161","271","151","101","50"
"CISR","1432","1161","271","2","1","1"
"CIST","1432","1161","271","20","8","12"
"CITE","1432","1161","271","3","1","2"
"CIVR","1432","1161","271","395","292","103"
"COAY","1432","1161","271","238","214","24"
"COGA","1432","1161","271","307","259","48"
"CTBI","1432","1161","271","145","123","22"
"CTCY","1432","1161","271","818","677","141"
"CTFL","1432","1161","271","302","228","74"
"CTHA","1432","1161","271","126","108","18"
"CTSP","1432","1161","271","12","7","5"
"CTSR","1432","1161","271","1185","953","232"
"DAAR","1432","1161","271","41","30","11"
"DAAU","1432","1161","271","51","45","6"
"DAMS","1432","1161","271","109","32","77"
"DARE","1432","1161","271","255","229","26"
"DART","1432","1161","271","2","1","1"
"DATR","1432","1161","271","53","44","9"
"DEMA","1432","1161","271","37","36","1"
"DIHY","1432","1161","271","15","9","6"
"ECBC","1432","1161","271","150","129","21"
"ECNA","1432","1161","271","9","8","1"
"ECOP","1432","1161","271","10","5","5"
"ELBI","1432","1161","271","67","62","5"
"EMPE","1432","1161","271","5","4","1"
"EPFA","1432","1161","271","46","40","6"
"EPHE","1432","1161","271","50","43","7"
"EPHO","1432","1161","271","7","3","4"
"EPIN","1432","1161","271","334","295","39"
"EPMA","1432","1161","271","4","3","1"
"EPME","1432","1161","271","38","27","11"
"EPML","1432","1161","271","39","24","15"
"EPSL","1432","1161","271","19","17","2"
"EPSP","1432","1161","271","44","34","10"
"EPTA","1432","1161","271","11","9","2"
"EXBR","1432","1161","271","29","26","3"
"FICO","1432","1161","271","11","10","1"
"FISH","1432","1161","271","26","8","18"
"FOFL","1432","1161","271","354","312","42"
"FOLO","1432","1161","271","226","196","30"
"GNAU","1432","1161","271","179","154","25"
"GOAT","1432","1161","271","15","6","9"
"GOBI","1432","1161","271","67","37","30"
"GOVA","1432","1161","271","1044","851","193"
"GRAL","1432","1161","271","194","158","36"
"GROU","1432","1161","271","4","2","2"
"GRSE","1432","1161","271","9","7","2"
"GYFL","1432","1161","271","4","3","1"
"GYJA","1432","1161","271","13","10","3"
"GYME","1432","1161","271","18","15","3"
"GYUC","1432","1161","271","47","43","4"
"GYUN","1432","1161","271","5","2","3"
"HABI","1432","1161","271","135","126","9"
"HAHO","1432","1161","271","1014","861","153"
"HAMA","1432","1161","271","178","163","15"
"HAME","1432","1161","271","44","36","8"
"HAML","1432","1161","271","13","9","4"
"HAMT","1432","1161","271","215","171","44"
"HAOR","1432","1161","271","478","388","90"
"HAPR","1432","1161","271","31","26","5"
"HATR","1432","1161","271","43","32","11"
"HEAC","1432","1161","271","4","3","1"
"HECA","1432","1161","271","3","2","1"
"HECH","1432","1161","271","143","127","16"
"HEFA","1432","1161","271","480","441","39"
"HEME","1432","1161","271","93","88","5"
"HEMO","1432","1161","271","93","88","5"
"HEPO","1432","1161","271","54","48","6"
"HETH","1432","1161","271","131","113","18"
"HEVA","1432","1161","271","125","111","14"
"HODO","1432","1161","271","63","58","5"
"ISSP","1432","1161","271","3","2","1"
"KYCI","1432","1161","271","26","23","3"
"LABI","1432","1161","271","431","359","72"
"LADI","1432","1161","271","893","673","220"
"LARU","1432","1161","271","701","592","109"
"LAUN","1432","1161","271","129","120","9"
"LAXA","1432","1161","271","546","465","81"
"LEOL","1432","1161","271","25","23","2"
"LERU","1432","1161","271","13","12","1"
"LETA","1432","1161","271","44","30","14"
"LETH","1432","1161","271","46","42","4"
"LIZA","1432","1161","271","80","74","6"
"LUBO","1432","1161","271","620","534","86"
"LUFU","1432","1161","271","139","120","19"
"LUGI","1432","1161","271","107","88","19"
"LUKA","1432","1161","271","225","170","55"
"LUMO","1432","1161","271","186","164","22"
"LUWH","1432","1161","271","5","3","2"
"MABR","1432","1161","271","54","50","4"
"MALA","1432","1161","271","77","70","7"
"MAMA","1432","1161","271","194","171","23"
"MAME","1432","1161","271","467","415","52"
"MANI","1432","1161","271","316","300","16"
"MEAT","1432","1161","271","84","60","24"
"MENI","1432","1161","271","395","337","58"
"MEVI","1432","1161","271","1232","1035","197"
"MOGR","1432","1161","271","555","478","77"
"MORA","1432","1161","271","3","1","2"
"MUFL","1432","1161","271","25","22","3"
"MUVA","1432","1161","271","136","126","10"
"MYAD","1432","1161","271","16","13","3"
"MYAM","1432","1161","271","19","18","1"
"MYBE","1432","1161","271","227","177","50"
"MYKU","1432","1161","271","116","96","20"
"MYMU","1432","1161","271","11","10","1"
"MYSP","1432","1161","271","35","29","6"
"NAAN","1432","1161","271","8","6","2"
"NABH","1432","1161","271","17","16","1"
"NABR","1432","1161","271","156","131","25"
"NAHE","1432","1161","271","178","152","26"
"NALI","1432","1161","271","829","720","109"
"NASP","1432","1161","271","21","7","14"
"NATH","1432","1161","271","5","4","1"
"NATO","1432","1161","271","48","45","3"
"NAUN","1432","1161","271","63","56","7"
"NAVL","1432","1161","271","210","190","20"
"NEAR","1432","1161","271","44","35","9"
"NEMA","1432","1161","271","220","172","48"
"NEOP","1432","1161","271","23","20","3"
"NESA","1432","1161","271","97","77","20"
"NESP","1432","1161","271","35","32","3"
"NOTA","1432","1161","271","47","40","7"
"ODNI","1432","1161","271","87","80","7"
"OSAN","1432","1161","271","15","12","3"
"OSCU","1432","1161","271","11","7","4"
"OSME","1432","1161","271","147","138","9"
"OXDI","1432","1161","271","304","277","27"
"OXLO","1432","1161","271","62","54","8"
"OXUN","1432","1161","271","848","764","84"
"PAAR","1432","1161","271","1068","866","202"
"PABA","1432","1161","271","26","18","8"
"PACL","1432","1161","271","149","135","14"
"PACR","1432","1161","271","105","102","3"
"PACY","1432","1161","271","601","544","57"
"PAFO","1432","1161","271","568","462","106"
"PAHE","1432","1161","271","341","265","76"
"PAIN","1432","1161","271","356","324","32"
"PAMI","1432","1161","271","98","95","3"
"PAMU","1432","1161","271","857","743","114"
"PAPL","1432","1161","271","53","50","3"
"PARR","1432","1161","271","188","131","57"
"PEJA","1432","1161","271","13","11","2"
"PEME","1432","1161","271","5","2","3"
"PEOU","1432","1161","271","238","198","40"
"PLDI","1432","1161","271","853","717","136"
"PLGI","1432","1161","271","5","4","1"
"PLIM","1432","1161","271","22","20","2"
"PLJO","1432","1161","271","700","554","146"
"PLLA","1432","1161","271","587","473","114"
"PLLD","1432","1161","271","22","21","1"
"PLLV","1432","1161","271","60","58","2"
"PLPH","1432","1161","271","63","60","3"
"PLPI","1432","1161","271","13","11","2"
"PLRH","1432","1161","271","7","1","6"
"PLTA","1432","1161","271","211","140","71"
"PLVI","1432","1161","271","85","72","13"
"POBR","1432","1161","271","278","224","54"
"POCO","1432","1161","271","268","222","46"
"POIM","1432","1161","271","183","164","19"
"POPA","1432","1161","271","6","3","3"
"POPH","1432","1161","271","95","58","37"
"POPU","1432","1161","271","8","7","1"
"PORI","1432","1161","271","286","258","28"
"POVA","1432","1161","271","899","741","158"
"PSCO","1432","1161","271","6","5","1"
"PSEV","1432","1161","271","232","186","46"
"PSFL","1432","1161","271","66","60","6"
"PSHE","1432","1161","271","715","547","168"
"PSMO","1432","1161","271","164","152","12"
"PSOC","1432","1161","271","481","370","111"
"PSOL","1432","1161","271","14","12","2"
"PSPA","1432","1161","271","360","294","66"
"PSTE","1432","1161","271","306","228","78"
"PTEV","1432","1161","271","305","247","58"
"PTHE","1432","1161","271","73","68","5"
"PTMA","1432","1161","271","43","42","1"
"PTTI","1432","1161","271","159","153","6"
"PTTR","1432","1161","271","19","17","2"
"PTZE","1432","1161","271","32","30","2"
"PYDI","1432","1161","271","651","567","84"
"RHLU","1432","1161","271","6","5","1"
"RHRE","1432","1161","271","101","99","2"
"SACA","1432","1161","271","76","70","6"
"SADI","1432","1161","271","24","22","2"
"SAMI","1432","1161","271","5","4","1"
"SASP","1432","1161","271","153","115","38"
"SATI","1432","1161","271","280","222","58"
"SCAL","1432","1161","271","48","43","5"
"SCFO","1432","1161","271","613","514","99"
"SCFR","1432","1161","271","195","175","20"
"SCGL","1432","1161","271","132","123","9"
"SCLY","1432","1161","271","22","21","1"
"SCNI","1432","1161","271","90","88","2"
"SCOV","1432","1161","271","332","272","60"
"SCPP","1432","1161","271","4","2","2"
"SCPS","1432","1161","271","192","167","25"
"SCRU","1432","1161","271","400","357","43"
"SCSC","1432","1161","271","156","137","19"
"SCSI","1432","1161","271","143","138","5"
"SCSP","1432","1161","271","71","30","41"
"SCTR","1432","1161","271","16","14","2"
"SCXA","1432","1161","271","30","26","4"
"SIAR","1432","1161","271","26","22","4"
"SNDP","1432","1161","271","40","23","17"
"SOLD","1432","1161","271","16","1","15"
"SPBA","1432","1161","271","34","33","1"
"SPQE","1432","1161","271","25","21","4"
"STAL","1432","1161","271","19","17","2"
"STBN","1432","1161","271","149","139","10"
"STFA","1432","1161","271","423","345","78"
"STNI","1432","1161","271","36","35","1"
"STSP","1432","1161","271","19","9","10"
"STST","1432","1161","271","33","32","1"
"SUBU","1432","1161","271","495","416","79"
"SUCH","1432","1161","271","136","119","17"
"SURG","1432","1161","271","110","64","46"
"SYBI","1432","1161","271","3","1","2"
"SYVA","1432","1161","271","6","5","1"
"THAL","1432","1161","271","4","2","2"
"THAM","1432","1161","271","274","248","26"
"THHA","1432","1161","271","152","125","27"
"THLU","1432","1161","271","424","321","103"
"THPU","1432","1161","271","57","54","3"
"THQU","1432","1161","271","935","767","168"
"THSP","1432","1161","271","5","4","1"
"THTR","1432","1161","271","46","45","1"
"TRBA","1432","1161","271","3","2","1"
"TROB","1432","1161","271","57","53","4"
"VALO","1432","1161","271","180","151","29"
"VAST","1432","1161","271","155","123","32"
"WRAS","1432","1161","271","134","57","77"
"XAAU","1432","1161","271","19","12","7"
"ZACO","1432","1161","271","455","423","32"
"ZERO","1432","1161","271","69","54","15"
"ZESC","1432","1161","271","522","437","85"
"ZEVE","1432","1161","271","331","300","31"
